111111111111111111111
401000100000001000001
101011111110101110111
100000000000100010001
111110111111111110111
100010101000101010001
101010101011101010101
101010000010101000101
101110111110101110101
100010000000000000101
111010111111111110111
100000000010001000101
111110111110101010101
101010000000101010001
101011101111111111101
100000100010100000101
101011111110101111101
101010000000100000001
101111101110101110111
100000001000000010003
111111111111111111111
