111111111111111111111111111111111
400000001000000010001000000000001
111011111110111011101010101110111
101000101010101010001010101000001
101011101010101010111010111110111
100000100000100000100010100000001
111010111110111110101111111110111
100010100010000010001010101000101
101011101111111111101010101011101
101010000000100000000010000000101
101110111010111110101111101011101
100000101010100000100010001000001
111010101111101010111011111111111
100010001000001010100000000000001
101011101010111110101011111110101
101010100010001000101000001000101
101010111011101111111111111111111
101000100010001010001000000000001
111111111011111011101110111010111
100000100010101010000000001010001
101110101010101011111111111110111
100010101000100000101010001000001
111010111010111010101010111010111
100010001010100010001000100010001
111011111110111110111110101010111
100000101000000010000010001010101
101111101010111110111110111110101
100010000010000000100000001000001
101111111011111110111111101111101
100010000000100000100010000000101
101011101011101010101010101111101
101000001010001010001000100000101
111111111111111111111111111111131
